########
#@     #
#    $ #
#      #
###  ###
# $    #
#     .#
#     .#
########
