########
# @##  #
# $##  #
#  ##  #
#  ##  #
# .##  #
#      #
#      #
########
