########
# @##. #
# $##  #
#  ##  #
#  ##  #
#  ##  #
#      #
#      #
########
