########
# @##..#
# $##  #
#  ##  #
# $##  #
#  ##  #
#      #
#      #
########
