########
#@     #
#    $ #
# $    #
###  ###
# $    #
#     .#
#    ..#
########
