    #####
    #   #
    #$  #
  ###   ##
  #  $   #
### # ## #   ######
#   # ## #####    #
#                 #
##### ### #@##  ..#
    #     #########
    #######
