######################################################
#@                                                   #
#                                           $        #
#                                                    #
#                                                    #
#       $            ########################        #
#                                                    #
#                                                    #
#                                                    #
#     ################################               #
#                                                    #
#                                                    #
#                                                    #
#                                                    #
# #############     ##########     ###########  ##   #
#                                                    #
#                                $                   #
#                                                    #
#                                                    #
#         ##############    ##############           #
#                                                    #
#                                                    #
#      $                                             #
#                                                    #
#                                                    #
#           ##############################           #
#                                                    #
#                                                    #
#                                             ....   #
######################################################
