     #######
######     ######
#    $     $    #
#  ###     ###  #
#    #  @  #    #
#    #     #    #
#  $$#     #$$  #
#   $       $   #
###### ### ######
   #    #    #
   #..  #  ..#
   #..  #  ..#
   ###########
