###########################################################
#                                                         #
#   @               $                                     #
#                                             .           #
#                                                         #
#                                                         #
#                                                         #
#                                                         #
#                            $                            #
#                   $                                   . #
#                                                 $       #
#                                                         #
#       $                                                 #
#                                  .           .        . #
#                                                         #
###########################################################
