 ######
 #    #
 # ## #
## .$.#
#  $@$##
# #.$. #
# # ## #
#      #
########
