#######
#     #
#     #
#  #  #
#$$$$$#
#..@..#
#######
